NO ./textures/obstacle1.xpm
SO ./textures/obstacle2.xpm
WE ./textures/obstacle3.xpm
EA ./textures/obstacle4.xpm
F 220,100,0
C 225,30,0
1111111111111111111111111
1000000000000000000000001
10N1101110111011101110111
1000100001000010000100001
1110101010101010101010111
1000100010001000100010001
1011101110111011101110111
10000000000000000000000W1
1111111111111111111111111